00000000000000000000
01111111101111111100
01001000101000100100
01001000101000100100
01001000101000100100
01111111111111111100
01001010000010100100
01111010000010111100
00001011101110100000
00001000101000100000
00001011111110100000
00001010000010100000
00001010000010100000
01111110000011111100
00001010000010100000
00001011111110100000
00001010000010100000
00001111101111100000
01111000101000111100
01001111111111100100
01001010000010100100
01111011101110111100
01000000101000000100
01111111111111111100
00000000000000000000
